00 00 00 00 00 00 00 00 00 00 00 00 00 00
00 00 00 00 00 00 00 00 00 00 00 00 00 00
00 01 01 01 07 26 28 28 27 01 01 01 01 xx
xx 01 01 01 07 26 28 32 23 01 01 01 02 xx
xx 01 01 01 07 22 31 27 01 01 02 02 02 xx
xx 01 01 01 07 01 22 23 01 01 02 02 02 xx
xx 01 11 06 08 01 01 01 01 01 01 02 02 xx
xx 01 07 02 02 01 01 01 01 01 01 02 02 xx
xx 01 07 02 02 01 02 01 01 01 01 02 02 xx
xx 01 07 02 01 01 02 02 02 01 01 01 02 xx
xx xx xx xx xx xx xx xx xx xx xx xx xx xx
xx xx xx xx xx xx xx xx xx xx xx xx xx xx
aaaaaaaaaaaaaaaaa
fdfduyfhjg