00 00 00 00 00 00 00 00 00 00 00 00 00 00
00 00 00 00 00 00 00 00 00 00 00 00 00 00
00 01 01 01 07 02 02 02 02 01 01 01 02 xx
xx 01 01 01 07 02 02 02 01 01 02 02 02 xx
xx 01 01 01 07 01 02 02 01 01 02 02 02 xx
xx 01 11 06 08 01 01 02 01 01 01 02 02 xx
xx 01 07 02 02 01 01 01 01 01 01 02 02 xx
xx 01 07 02 02 01 02 01 01 01 01 02 02 xx
xx 01 07 02 01 01 02 02 02 01 01 01 02 xx
xx 04 07 01 01 02 02 02 02 02 02 01 05 xx
xx xx xx xx xx xx xx xx xx xx xx xx xx xx
xx xx xx xx xx xx xx xx xx xx xx xx xx xx
aaaaaaaaaaaaaaaaaыыыыыыыыыыыыыыыыыыыыыыыыыыы
fdfduyfhjg