00 00 00 00 00 00 00 00 00 00 00 00 00 00
00 00 00 00 00 00 00 00 00 00 00 00 00 00
00 01 03 03 07 26 28 28 27 03 03 01 04 xx
xx 01 01 03 07 26 28 32 23 01 01 01 20 xx
xx 01 01 03 07 22 31 27 01 01 20 24 29 xx
xx 01 01 01 12 01 22 23 03 01 22 31 28 xx
xx 01 11 06 08 01 01 03 03 01 01 26 28 xx
xx 01 07 20 21 01 01 01 01 01 01 26 28 xx
xx 01 07 26 27 01 20 21 01 01 01 22 25 xx
xx 04 07 26 27 04 26 30 21 01 01 01 51 xx
xx xx xx xx xx xx xx xx xx xx xx xx xx xx
xx xx xx xx xx xx xx xx xx xx xx xx xx xx
Надо использовать функцию
"повторять", чтобы пройти уровень
